11111111111111111111
10000000000000000001
10111111111111111101
10100000000000000101
10101111111111110101
10101000000000010101
10101011111111010101
10101010000000010101
10101010111111110101
10100010100000000101
10101010001111110101
10101010101000010101
10101010101011111101
10101010101010000001
10101010101010111101
10101010101010100101
10101010101010000101
10001010101010111111
A010101010001000000B
11111111111111111111
