111111110B
1001000001
1011101111
1000000101
1011111101
1000010001
1010111101
1000100000
1011111011
A000000001
