1111111111
1001000001
1011111101
1000000001
1011110111
1000B10001
1111111101
1000000000
1011101011
A001000001